1111111111
1001200001
1001110101
1430110101
1000003101
1011100301
1012100001
1010000001
1210000001
1111111111
